--------w--------
-a------w--------
--------w--------
--------w--------
--------w--------
-----------------
--------w--------
--------w--------
wwww-wwwwwwww-www
--------wg-------
--------w--------
--------w--------
--------w--------
--------w--------
--------w--------
-----------------
--------w--------
